WWWWWWWWWWWWWWWWWWWW
W.......F.....L....W
W.............L.W..W
W...W...WWWWWW.....W
W...W..............W
W...............L..W
W...W...W.......F..W
W.......W...L..L...W
W...W...P..........W
W...W...W....F.....W
W...W...W....WW....W
W...W..............W
W...W...H..........W
W...W...W.......F..W
W...F........L.....W
W...W...W....F.....W
W...W...W..........W
W...W...W....L.....W
W...W...W....F.....W
WWWWWWWWWWWWWWWWWWWW
